{
    "Floor0" : {
        "1"  : [ " "," "," "," "," "," "," "," "," "," "," "," "," "," "," "," "," "," "," "," " ],
        "2"  : [ " "," "," "," "," "," "," "," "," "," "," "," "," "," "," "," "," "," "," "," " ],
        "3"  : [ " "," "," "," "," "," ","┌","-","┬","-","┬","-","┬","-","┬","-","┬","-","┬","-" ],
        "4"  : [ " "," "," "," "," "," ","|"," "," "," "," "," "," "," "," "," "," "," "," ","UIT" ],
        "5"  : [ " "," "," "," "," "," ","├"," ","┼","-","┼","-","┼","-","┼","-","┼"," ","┼","-" ],
        "6"  : [ " "," "," "," "," "," ","|"," ","|"," "," "," "," "," ","|","█","|"," ","|"," " ],
        "7"  : [ " "," "," "," ","┌","-","┼"," ","┼"," ","┼"," ","┼"," ","┼","-","┼"," ","┤"," " ],
        "8"  : [ " "," "," "," ","|"," "," "," ","|"," "," "," "," "," ","|","█","|"," ","|"," " ],
        "9"  : [ " "," "," "," ","├"," ","┼","-","┼","-","┼"," ","┼","-","┼","-","┼"," ","┤"," " ],
        "10" : [ " "," "," "," ","|"," ","|"," "," "," "," "," ","|"," ","|","█","|"," ","|"," " ],
        "11" : [ " "," "," "," ","├"," ","┼","-","┼"," ","┼"," ","┼"," ","┼","-","┼"," ","┤"," " ],
        "12" : [ " "," "," "," ","|"," ","|"," ","|"," ","|"," "," ","^"," "," "," "," ","|"," " ],
        "13" : [ " "," "," "," ","├"," ","┼"," ","┼"," ","┼"," ","┼","-","┼","-","┼"," ","┤"," " ],
        "14" : [ " "," "," "," ","|"," ","|"," "," "," "," "," ","|"," ","|","█","|"," ","|"," " ],
        "15" : [ " "," "," "," ","├"," ","┼","-","┼","-","┼"," ","┼"," ","┼","-","┼"," ","┤"," " ],
        "16" : [ " "," "," "," ","|"," "," "," ","|"," "," "," "," "," ","|","█","|"," ","|"," " ],
        "17" : [ " "," "," "," ","└","-","┼"," ","┼","-","┼"," ","┼"," ","┼"," ","┼"," ","┤"," " ],
        "18" : [ " "," "," "," "," "," ","|"," ","|"," "," "," "," "," ","|","█","|"," ","|"," " ],
        "19" : [ " "," "," "," "," "," ","├"," ","┼","-","┼","-","┼","-","┼","-","┼"," ","┤"," " ],
        "20" : [ " "," "," "," "," "," ","|"," "," "," "," "," "," "," "," "," "," "," ","|"," " ],
        "21" : [ " "," "," "," "," "," ","└","-","┴","-","┴","-","┴","-","┴","-","┴","-","┘"," " ],
        "22" : [ " "," "," "," "," "," "," "," "," "," "," "," "," "," "," "," "," "," "," "," " ],
        "23" : [ " "," "," "," "," "," "," "," "," "," "," "," "," "," "," "," "," "," "," "," " ],
        "24" : [ " "," "," "," "," "," "," "," "," "," "," "," "," "," "," "," "," "," "," "," " ],
        "25" : [ " "," "," "," "," "," "," "," "," "," "," "," "," "," "," "," "," "," "," "," " ]
    },

    "Floor1" : {
        "1"  : [ " "," "," "," "," "," "," "," "," "," "," "," "," "," "," "," "," "," "," "," " ],
        "2"  : [ " "," "," "," "," "," "," "," "," "," "," "," "," "," "," "," "," "," "," "," " ],
        "3"  : [ " "," "," "," "," "," "," "," "," "," "," "," "," "," "," "," "," "," "," "," " ],
        "4"  : [ " "," "," "," "," "," "," "," "," "," "," "," "," "," "," "," "," "," "," "," " ],
        "5"  : [ " "," "," "," "," "," "," "," "," "," ","┌","-","┬","-","┐"," "," "," "," "," " ],
        "6"  : [ " "," "," "," "," "," "," "," "," "," ","|"," "," "," ","|"," "," "," "," "," " ],
        "7"  : [ " "," "," "," "," "," "," "," "," "," ","├","-","┼"," ","┤"," "," "," "," "," " ],
        "8"  : [ " "," "," "," "," "," "," "," "," "," ","|"," "," "," ","|"," "," "," "," "," " ],
        "9"  : [ " "," "," "," "," "," "," "," ","┌","-","┼","-","┼"," ","┤"," "," "," "," "," " ],
        "10" : [ " "," "," "," "," "," "," "," ","|"," ","|"," "," "," ","|"," "," "," "," "," " ],
        "11" : [ " "," "," "," "," "," "," "," ","├"," ","┼","-","┼"," ","┤"," "," "," "," "," " ],
        "12" : [ " "," "," "," "," "," "," "," ","|"," "," "," "," ","^","|"," "," "," "," "," " ],
        "13" : [ " "," "," "," "," "," "," "," ","├"," ","┼","-","┼"," ","┤"," "," "," "," "," " ],
        "14" : [ " "," "," "," "," "," "," "," ","|"," ","|"," "," "," ","|"," "," "," "," "," " ],
        "15" : [ " "," "," "," "," "," "," "," ","├"," ","┼","-","┼"," ","┤"," "," "," "," "," " ],
        "16" : [ " "," "," "," "," "," "," "," ","|"," ","|"," "," "," ","|"," "," "," "," "," " ],
        "17" : [ " "," "," "," "," "," "," "," ","├"," ","┼"," ","┼"," ","┤"," "," "," "," "," " ],
        "18" : [ " "," "," "," "," "," "," "," ","|"," ","|"," "," "," ","|"," "," "," "," "," " ],
        "19" : [ " "," "," "," "," "," "," "," ","└","-","┴","-","┴","-","┘"," "," "," "," "," " ],
        "20" : [ " "," "," "," "," "," "," "," "," "," "," "," "," "," "," "," "," "," "," "," " ],
        "21" : [ " "," "," "," "," "," "," "," "," "," "," "," "," "," "," "," "," "," "," "," " ],
        "22" : [ " "," "," "," "," "," "," "," "," "," "," "," "," "," "," "," "," "," "," "," " ],
        "23" : [ " "," "," "," "," "," "," "," "," "," "," "," "," "," "," "," "," "," "," "," " ],
        "24" : [ " "," "," "," "," "," "," "," "," "," "," "," "," "," "," "," "," "," "," "," " ],
        "25" : [ " "," "," "," "," "," "," "," "," "," "," "," "," "," "," "," "," "," "," "," " ]
    },

    "Floor2" : {
        "1"  : [ " "," "," "," "," "," "," "," "," "," "," "," "," "," "," "," "," "," "," "," " ],
        "2"  : [ " "," "," "," "," "," "," "," "," "," "," "," "," "," "," "," "," "," "," "," " ],
        "3"  : [ " "," "," "," "," "," "," "," "," "," "," "," "," "," "," "," "," "," "," "," " ],
        "4"  : [ " "," "," "," "," "," "," "," "," "," "," "," "," "," "," "," "," "," "," "," " ],
        "5"  : [ " "," "," "," "," "," "," "," "," "," ","┌","-","┬","-","┐"," "," "," "," "," " ],
        "6"  : [ " "," "," "," "," "," "," "," "," "," ","|"," "," "," ","|"," "," "," "," "," " ],
        "7"  : [ " "," "," "," "," "," "," "," "," "," ","├"," ","┼"," ","┤"," "," "," "," "," " ],
        "8"  : [ " "," "," "," "," "," "," "," "," "," ","|"," "," "," ","|"," "," "," "," "," " ],
        "9"  : [ " "," "," "," "," "," "," "," ","┌","-","┼","-","┼"," ","┤"," "," "," "," "," " ],
        "10" : [ " "," "," "," "," "," "," "," ","|"," "," "," "," "," ","|"," "," "," "," "," " ],
        "11" : [ " "," "," "," "," "," "," "," ","├"," ","┼","-","┼"," ","┤"," "," "," "," "," " ],
        "12" : [ " "," "," "," "," "," "," "," ","|"," "," "," "," ","^","|"," "," "," "," "," " ],
        "13" : [ " "," "," "," "," "," "," "," ","├"," ","┼","-","┼"," ","┤"," "," "," "," "," " ],
        "14" : [ " "," "," "," "," "," "," "," ","|"," ","|"," "," "," ","|"," "," "," "," "," " ],
        "15" : [ " "," "," "," "," "," "," "," ","└","-","┼","-","┼"," ","┤"," "," "," "," "," " ],
        "16" : [ " "," "," "," "," "," "," "," "," "," ","|"," "," "," ","|"," "," "," "," "," " ],
        "17" : [ " "," "," "," "," "," "," "," "," "," ","┼"," ","┼","-","┤"," "," "," "," "," " ],
        "18" : [ " "," "," "," "," "," "," "," "," "," ","|"," "," "," ","|"," "," "," "," "," " ],
        "19" : [ " "," "," "," "," "," "," "," "," "," ","└","-","┴","-","┘"," "," "," "," "," " ],
        "20" : [ " "," "," "," "," "," "," "," "," "," "," "," "," "," "," "," "," "," "," "," " ],
        "21" : [ " "," "," "," "," "," "," "," "," "," "," "," "," "," "," "," "," "," "," "," " ],
        "22" : [ " "," "," "," "," "," "," "," "," "," "," "," "," "," "," "," "," "," "," "," " ],
        "23" : [ " "," "," "," "," "," "," "," "," "," "," "," "," "," "," "," "," "," "," "," " ],
        "24" : [ " "," "," "," "," "," "," "," "," "," "," "," "," "," "," "," "," "," "," "," " ],
        "25" : [ " "," "," "," "," "," "," "," "," "," "," "," "," "," "," "," "," "," "," "," " ]
    },

    "Floor3" : {
        "1"  : [ " "," "," "," "," "," "," "," "," "," "," "," "," "," "," "," "," "," "," "," " ],
        "2"  : [ " "," "," "," "," "," "," "," "," "," "," "," "," "," "," "," "," "," "," "," " ],
        "3"  : [ " "," "," "," "," "," "," "," "," "," "," "," "," "," "," "," "," "," "," "," " ],
        "4"  : [ " "," "," "," "," "," "," "," "," "," "," "," "," "," "," "," "," "," "," "," " ],
        "5"  : [ " "," "," "," "," "," "," "," "," "," ","┌","-","┬","-","┐"," "," "," "," "," " ],
        "6"  : [ " "," "," "," "," "," "," "," "," "," ","|"," "," "," ","|"," "," "," "," "," " ],
        "7"  : [ " "," "," "," "," "," "," "," "," "," ","├"," ","┼"," ","┤"," "," "," "," "," " ],
        "8"  : [ " "," "," "," "," "," "," "," "," "," ","|"," "," "," ","|"," "," "," "," "," " ],
        "9"  : [ " "," "," "," "," "," "," "," ","┌","-","┼"," ","┼"," ","┤"," "," "," "," "," " ],
        "10" : [ " "," "," "," "," "," "," "," ","|"," "," "," "," "," ","|"," "," "," "," "," " ],
        "11" : [ " "," "," "," "," "," "," "," ","├"," ","┼","-","┼"," ","┤"," "," "," "," "," " ],
        "12" : [ " "," "," "," "," "," "," "," ","|"," "," "," "," ","^","|"," "," "," "," "," " ],
        "13" : [ " "," "," "," "," "," "," "," ","├"," ","┼","-","┼"," ","┤"," "," "," "," "," " ],
        "14" : [ " "," "," "," "," "," "," "," ","|"," "," "," "," "," ","|"," "," "," "," "," " ],
        "15" : [ " "," "," "," "," "," "," "," ","└","-","┼"," ","┼"," ","┤"," "," "," "," "," " ],
        "16" : [ " "," "," "," "," "," "," "," "," "," ","|"," "," "," ","|"," "," "," "," "," " ],
        "17" : [ " "," "," "," "," "," "," "," "," "," ","┼"," ","┼"," ","┤"," "," "," "," "," " ],
        "18" : [ " "," "," "," "," "," "," "," "," "," ","|"," "," "," ","|"," "," "," "," "," " ],
        "19" : [ " "," "," "," "," "," "," "," "," "," ","└","-","┴","-","┘"," "," "," "," "," " ],
        "20" : [ " "," "," "," "," "," "," "," "," "," "," "," "," "," "," "," "," "," "," "," " ],
        "21" : [ " "," "," "," "," "," "," "," "," "," "," "," "," "," "," "," "," "," "," "," " ],
        "22" : [ " "," "," "," "," "," "," "," "," "," "," "," "," "," "," "," "," "," "," "," " ],
        "23" : [ " "," "," "," "," "," "," "," "," "," "," "," "," "," "," "," "," "," "," "," " ],
        "24" : [ " "," "," "," "," "," "," "," "," "," "," "," "," "," "," "," "," "," "," "," " ],
        "25" : [ " "," "," "," "," "," "," "," "," "," "," "," "," "," "," "," "," "," "," "," " ]
    },

    "Floor4" : {
        "1"  : [ " "," "," "," "," "," "," "," "," "," "," "," "," "," "," "," "," "," "," "," " ],
        "2"  : [ " "," "," "," "," "," "," "," "," "," "," "," "," "," "," "," "," "," "," "," " ],
        "3"  : [ " "," "," "," "," "," "," "," "," "," "," "," "," "," "," "," "," "," "," "," " ],
        "4"  : [ " "," "," "," "," "," "," "," "," "," "," "," "," "," "," "," "," "," "," "," " ],
        "5"  : [ " "," "," "," "," "," "," "," "," "," "," "," "," "," "," "," "," "," "," "," " ],
        "6"  : [ " "," "," "," "," "," "," "," "," "," "," "," "," "," "," "," "," "," "," "," " ],
        "7"  : [ " "," "," "," "," "," "," "," "," "," "," "," "," "," "," "," "," "," "," "," " ],
        "8"  : [ " "," "," "," "," "," "," "," "," "," "," "," "," "," "," "," "," "," "," "," " ],
        "9"  : [ " "," "," "," "," "," "," "," "," "," "," "," ","┌","-","┐"," "," "," "," "," " ],
        "10" : [ " "," "," "," "," "," "," "," "," "," "," "," ","|"," ","|"," "," "," "," "," " ],
        "11" : [ " "," "," "," "," "," "," "," "," "," ","┌","-","┼"," ","┤"," "," "," "," "," " ],
        "12" : [ " "," "," "," "," "," "," "," "," "," ","|"," "," ","v","|"," "," "," "," "," " ],
        "13" : [ " "," "," "," "," "," "," "," "," "," ","└","-","┼"," ","┤"," "," "," "," "," " ],
        "14" : [ " "," "," "," "," "," "," "," "," "," "," "," ","|"," ","|"," "," "," "," "," " ],
        "15" : [ " "," "," "," "," "," "," "," "," "," "," "," ","└","-","┘"," "," "," "," "," " ],
        "16" : [ " "," "," "," "," "," "," "," "," "," "," "," "," "," "," "," "," "," "," "," " ],
        "17" : [ " "," "," "," "," "," "," "," "," "," "," "," "," "," "," "," "," "," "," "," " ],
        "18" : [ " "," "," "," "," "," "," "," "," "," "," "," "," "," "," "," "," "," "," "," " ],
        "19" : [ " "," "," "," "," "," "," "," "," "," "," "," "," "," "," "," "," "," "," "," " ],
        "20" : [ " "," "," "," "," "," "," "," "," "," "," "," "," "," "," "," "," "," "," "," " ],
        "21" : [ " "," "," "," "," "," "," "," "," "," "," "," "," "," "," "," "," "," "," "," " ],
        "22" : [ " "," "," "," "," "," "," "," "," "," "," "," "," "," "," "," "," "," "," "," " ],
        "23" : [ " "," "," "," "," "," "," "," "," "," "," "," "," "," "," "," "," "," "," "," " ],
        "24" : [ " "," "," "," "," "," "," "," "," "," "," "," "," "," "," "," "," "," "," "," " ],
        "25" : [ " "," "," "," "," "," "," "," "," "," "," "," "," "," "," "," "," "," "," "," " ]
    },
    "Floor98" : {
        "1"  : [ " "," "," "," "," "," "," "," "," "," ","┌","-","┐"," "," "," "," "," "," "," " ],
        "2"  : [ " "," "," "," "," "," "," "," "," "," ","|"," ","|"," "," "," "," "," "," "," " ],
        "3"  : [ " "," "," "," "," "," "," "," "," "," ","┘"," ","└"," "," "," "," "," "," "," " ],
        "4"  : [ " "," "," "," "," "," "," "," "," "," "," "," ",""," "," "," ","(de gele ","X"," is je huidige locatie)"," "," "," "," "," " ],
        "5"  : [ " "," "," "," "," "," "," "," "," "," ","┐"," ","┌"," "," "," "," "," "," "," " ],
        "6"  : [ " "," "," "," "," "," "," "," "," "," ","|"," ","|"," "," "," "," "," "," "," " ],
        "7"  : [ " "," "," "," "," "," "," "," "," "," ","├"," ","┤"," "," "," "," "," "," "," " ],
        "8"  : [ " "," "," "," "," "," "," "," "," "," ","|"," ","|"," "," "," "," "," "," "," " ],
        "9"  : [ " "," "," "," "," "," "," "," "," "," ","├"," ","┤"," "," "," "," "," "," "," " ],
        "10" : [ " "," "," "," "," "," "," "," "," "," ","|"," ","|"," "," "," "," "," "," "," " ],
        "11" : [ " "," "," "," "," "," "," "," "," "," ","├"," ","┤"," "," "," "," "," "," "," " ],
        "12" : [ " "," "," "," "," "," "," "," "," "," ","|"," ","|"," "," "," "," "," "," "," " ],
        "13" : [ " "," "," "," "," "," "," "," "," "," ","└"," ","┘"," "," "," "," "," "," "," " ],
        "14" : [ " "," "," "," "," "," "," "," "," "," ","U","I","T"," "," "," "," "," "," "," " ],
        "15" : [ " "," "," "," "," "," "," "," "," "," "," "," "," "," "," "," "," "," "," "," " ],
        "16" : [ " "," "," "," "," "," "," "," "," "," "," "," "," "," "," "," "," "," "," "," " ],
        "17" : [ " "," "," "," "," "," "," "," "," "," "," "," "," "," "," "," "," "," "," "," " ],
        "18" : [ " "," "," "," "," "," "," "," "," "," "," "," "," "," "," "," "," "," "," "," " ],
        "19" : [ " "," "," "," "," "," "," "," "," "," "," "," "," "," "," "," "," "," "," "," " ],
        "20" : [ " "," "," "," "," "," "," "," "," "," "," "," "," "," "," "," "," "," "," "," " ],
        "21" : [ " "," "," "," "," "," "," "," "," "," "," "," "," "," "," "," "," "," "," "," " ],
        "22" : [ " "," "," "," "," "," "," "," "," "," "," "," "," "," "," "," "," "," "," "," " ],
        "23" : [ " "," "," "," "," "," "," "," "," "," "," "," "," "," "," "," "," "," "," "," " ],
        "24" : [ " "," "," "," "," "," "," "," "," "," "," "," "," "," "," "," "," "," "," "," " ],
        "25" : [ " "," "," "," "," "," "," "," "," "," "," "," "," "," "," "," "," "," "," "," " ]
    }
}